AAAGATGGTCCGAAGA-1	immune cells_clone1
AACCATGTCTCGTATT-1	immune cells_clone1
AACGTTGTCTCTTGAT-1	immune cells_clone1
AACTCAGAGCCTATGT-1	immune cells_clone1
AAGACCTAGATGTAAC-1	immune cells_clone1
AAGCCGCTCCTCAATT-1	immune cells_clone1
ACACCCTAGCGATAGC-1	immune cells_clone1
ACCCACTCAACGATGG-1	immune cells_clone1
ACCGTAATCAGATAAG-1	immune cells_clone1
ACGGAGAGTGGAAAGA-1	immune cells_clone1
ACTGCTCAGTGTACCT-1	immune cells_clone1
ACTTTCAAGAACTCGG-1	immune cells_clone1
ACTTTCATCCCAAGTA-1	immune cells_clone1
AGAGCGAAGCCCAGCT-1	immune cells_clone1
AGATCTGAGGGATGGG-1	immune cells_clone1
AGCATACCATTTGCTT-1	immune cells_clone1
AGCTCCTTCTTCTGGC-1	immune cells_clone1
AGCTCTCAGTATCTCG-1	immune cells_clone1
AGCTCTCGTGTAACGG-1	immune cells_clone1
ATAGACCCATGTCCTC-1	immune cells_clone1
ATCATGGGTTCCAACA-1	immune cells_clone1
ATCCACCGTAAGTGGC-1	immune cells_clone1
ATCTGCCTCAAGGTAA-1	immune cells_clone1
ATGCGATCAGAAGCAC-1	immune cells_clone1
ATGTGTGGTACCGCTG-1	immune cells_clone1
ATTATCCGTCCAGTTA-1	immune cells_clone1
CAACTAGGTAGCGTCC-1	immune cells_clone1
CAAGATCAGCTAAGAT-1	immune cells_clone1
CAAGATCGTGACGGTA-1	immune cells_clone1
CAAGATCTCCAGTATG-1	immune cells_clone1
CAAGATCTCTTAGCCC-1	immune cells_clone1
CACAGTAGTATCACCA-1	immune cells_clone1
CACATAGTCGAACTGT-1	immune cells_clone1
CACCAGGCAAGTACCT-1	immune cells_clone1
CACCTTGAGAGCTTCT-1	immune cells_clone1
CAGAATCGTATCACCA-1	immune cells_clone1
CAGATCACAGTAAGAT-1	immune cells_clone1
CAGCATAGTCAAGCGA-1	immune cells_clone1
CAGTCCTGTCCAAGTT-1	immune cells_clone1
CATATTCTCTCTGTCG-1	immune cells_clone1
CATCGGGAGATATGCA-1	immune cells_clone1
CATTCGCTCTATCCCG-1	immune cells_clone1
CCGTGGAAGTTAAGTG-1	immune cells_clone1
CCGTGGACATCCGCGA-1	immune cells_clone1
CCTAAAGCATGAGCGA-1	immune cells_clone1
CCTAAAGTCAGCAACT-1	immune cells_clone1
CGACCTTTCGGCGGTT-1	immune cells_clone1
CGAGCACTCGGTCCGA-1	immune cells_clone1
CGAGCCATCTGGCGTG-1	immune cells_clone1
CGCGGTAGTGTGAATA-1	immune cells_clone1
CGGACTGAGATAGGAG-1	immune cells_clone1
CGGAGCTTCTCGGACG-1	immune cells_clone1
CGGAGTCAGGCTCATT-1	immune cells_clone1
CGGAGTCAGTGGGCTA-1	immune cells_clone1
CGTGTCTAGTCGTACT-1	immune cells_clone1
CGTTCTGGTCATTAGC-1	immune cells_clone1
CGTTCTGGTCTGATCA-1	immune cells_clone1
CTAACTTAGACAGGCT-1	immune cells_clone1
CTCAGAACATGTCTCC-1	immune cells_clone1
CTCGAAAGTAGCTAAA-1	immune cells_clone1
CTCGGAGGTGGTAACG-1	immune cells_clone1
CTCGGGATCTTAACCT-1	immune cells_clone1
CTCTACGCACTGCCAG-1	immune cells_clone1
CTGCTGTCACAGATTC-1	immune cells_clone1
CTGGTCTAGGTGCTAG-1	immune cells_clone1
CTGTTTAAGTACATGA-1	immune cells_clone1
CTTAACTTCTCTGTCG-1	immune cells_clone1
GAAACTCTCCCTCAGT-1	immune cells_clone1
GAACATCTCGAACTGT-1	immune cells_clone1
GAATAAGTCGTTGACA-1	immune cells_clone1
GACCTGGGTACTTCTT-1	immune cells_clone1
GACCTGGGTTGTGGCC-1	immune cells_clone1
GACCTGGTCTGCGTAA-1	immune cells_clone1
GACGGCTGTCGAGTTT-1	immune cells_clone1
GACTACACAGTACACT-1	immune cells_clone1
GATGAAAAGTGTGAAT-1	immune cells_clone1
GATGAGGCAGCCTTGG-1	immune cells_clone1
GATGCTAGTCTGATCA-1	immune cells_clone1
GCATGATCAAAGGCGT-1	immune cells_clone1
GCATGATCAAGAGGCT-1	immune cells_clone1
GCATGCGTCAAACAAG-1	immune cells_clone1
GCCTCTAGTCATCGGC-1	immune cells_clone1
GCGCAGTGTGCACGAA-1	immune cells_clone1
GCGCCAACACCAGTTA-1	immune cells_clone1
GCGGGTTAGAGCTATA-1	immune cells_clone1
GCTCCTATCGTATCAG-1	immune cells_clone1
GCTCTGTTCGTGACAT-1	immune cells_clone1
GCTTCCAGTGATAAGT-1	immune cells_clone1
GGAACTTAGGGCATGT-1	immune cells_clone1
GGACATTAGGCGATAC-1	immune cells_clone1
GGACATTCATGTAGTC-1	immune cells_clone1
GGAGCAACAATCAGAA-1	immune cells_clone1
GGAGCAAGTAGAGGAA-1	immune cells_clone1
GGAGCAAGTAGCGTCC-1	immune cells_clone1
GGCGACTAGGCCCTTG-1	immune cells_clone1
GGCGACTCATCATCCC-1	immune cells_clone1
GGGAATGAGTACGACG-1	immune cells_clone1
GGGAATGAGTGACATA-1	immune cells_clone1
GGGACCTGTCATGCAT-1	immune cells_clone1
GGGATGACAATGGAAT-1	immune cells_clone1
GTACTCCGTAAACCTC-1	immune cells_clone1
GTATCTTGTTTGGCGC-1	immune cells_clone1
GTCACGGAGCTGAAAT-1	immune cells_clone1
GTCCTCAAGGCATGTG-1	immune cells_clone1
GTCGGGTCACTCAGGC-1	immune cells_clone1
GTCGGGTTCTTTAGGG-1	immune cells_clone1
GTCGTAAAGGGATCTG-1	immune cells_clone1
GTCGTAACAATCGGTT-1	immune cells_clone1
GTCTCGTTCCTGCAGG-1	immune cells_clone1
GTCTTCGGTAGGGTAC-1	immune cells_clone1
GTGAAGGTCTCTGCTG-1	immune cells_clone1
GTGCGGTTCTAACTGG-1	immune cells_clone1
GTGCTTCGTTGTGGCC-1	immune cells_clone1
GTGGGTCAGATATACG-1	immune cells_clone1
GTGGGTCCAAGCCATT-1	immune cells_clone1
GTTACAGGTATATCCG-1	immune cells_clone1
GTTCATTAGAGCCCAA-1	immune cells_clone1
GTTTCTATCTATGTGG-1	immune cells_clone1
TACGGTAGTAGCTTGT-1	immune cells_clone1
TACTCGCGTTCGCTAA-1	immune cells_clone1
TACTTGTAGGGCATGT-1	immune cells_clone1
TAGAGCTCACATTTCT-1	immune cells_clone1
TCAATCTCACCGGAAA-1	immune cells_clone1
TCAGATGAGTGTTTGC-1	immune cells_clone1
TCAGCTCAGACATAAC-1	immune cells_clone1
TCATTACCAGTATCTG-1	immune cells_clone1
TCGAGGCAGGCCATAG-1	immune cells_clone1
TCGAGGCCAGATGGGT-1	immune cells_clone1
TCGAGGCTCGTGGACC-1	immune cells_clone1
TCGGGACAGCAACGGT-1	immune cells_clone1
TCGTACCGTCTCAACA-1	immune cells_clone1
TCTCTAAGTTAGGGTG-1	immune cells_clone1
TCTGAGAAGCTGAACG-1	immune cells_clone1
TGACAACGTTAAGAAC-1	immune cells_clone1
TGAGCCGAGGAGTAGA-1	immune cells_clone1
TGCCCATTCCCTCTTT-1	immune cells_clone1
TGCCCTACAGCCTATA-1	immune cells_clone1
TGCGCAGGTTGACGTT-1	immune cells_clone1
TGCTACCAGCCGTCGT-1	immune cells_clone1
TGGCGCAGTAATCGTC-1	immune cells_clone1
TGGGAAGCAGGTCGTC-1	immune cells_clone1
TGTATTCAGAGCTTCT-1	immune cells_clone1
TGTATTCAGAGTTGGC-1	immune cells_clone1
TGTCCCATCGGTCTAA-1	immune cells_clone1
TTCTACAAGACTAGAT-1	immune cells_clone1
TTGAACGCATAGAAAC-1	immune cells_clone1
TTGTAGGAGGTGGGTT-1	immune cells_clone1
TTTACTGTCACGGTTA-1	immune cells_clone1
TTTATGCAGCTCAACT-1	immune cells_clone1
TTTGCGCTCCGAACGC-1	immune cells_clone1
AAAGTAGCACATGTGT-1	immune cells_clone2
AAGCCGCTCTGTGCAA-1	immune cells_clone2
AAGGTTCAGACCCACC-1	immune cells_clone2
ACACTGAGTCTTGATG-1	immune cells_clone2
ACCAGTATCCCACTTG-1	immune cells_clone2
ACCCACTGTAAGTGTA-1	immune cells_clone2
ACCTTTAGTTATTCTC-1	immune cells_clone2
ACGATGTCAAAGAATC-1	immune cells_clone2
ACGATGTCAATCGGTT-1	immune cells_clone2
ACGCCGAAGGGCACTA-1	immune cells_clone2
ACGGGCTTCAAGCCTA-1	immune cells_clone2
ACTTACTAGTATGACA-1	immune cells_clone2
AGAATAGGTATGAATG-1	immune cells_clone2
AGAGCGAAGTATGACA-1	immune cells_clone2
AGAGTGGTCAGCTTAG-1	immune cells_clone2
AGCGTATAGCCGCCTA-1	immune cells_clone2
AGCTCTCCAGCCTATA-1	immune cells_clone2
AGCTTGAAGAGCCCAA-1	immune cells_clone2
AGGCCACAGACAAGCC-1	immune cells_clone2
AGGTCATCACAAGCCC-1	immune cells_clone2
AGGTCATGTCTGATTG-1	immune cells_clone2
AGGTCCGGTATATCCG-1	immune cells_clone2
AGTGAGGAGTGGTAGC-1	immune cells_clone2
ATAAGAGAGAACAATC-1	immune cells_clone2
ATCACGATCTGGCGTG-1	immune cells_clone2
ATCATCTAGACTTGAA-1	immune cells_clone2
ATCGAGTCATCGACGC-1	immune cells_clone2
ATCGAGTGTCATATGC-1	immune cells_clone2
ATCTGCCCATTAACCG-1	immune cells_clone2
ATGAGGGAGCTACCGC-1	immune cells_clone2
ATGAGGGCACCACCAG-1	immune cells_clone2
ATTATCCTCCTAGTGA-1	immune cells_clone2
ATTGGTGAGCCCTAAT-1	immune cells_clone2
CACAAACAGACAATAC-1	immune cells_clone2
CACATTTAGTAGTGCG-1	immune cells_clone2
CACCACTCAGGCAGTA-1	immune cells_clone2
CACCTTGGTTCATGGT-1	immune cells_clone2
CAGCAGCGTCCCTTGT-1	immune cells_clone2
CAGCGACAGTGTCCCG-1	immune cells_clone2
CAGTAACAGGCAAAGA-1	immune cells_clone2
CAGTCCTTCCAAGTAC-1	immune cells_clone2
CATGCCTCAGGCTCAC-1	immune cells_clone2
CATGGCGCAGCTGCTG-1	immune cells_clone2
CCACCTATCGATCCCT-1	immune cells_clone2
CCGTGGAGTATAAACG-1	immune cells_clone2
CCTAAAGAGTGGACGT-1	immune cells_clone2
CCTAAAGTCTAACCGA-1	immune cells_clone2
CCTAGCTAGAAACGAG-1	immune cells_clone2
CCTAGCTTCACTATTC-1	immune cells_clone2
CCTTACGTCTTCATGT-1	immune cells_clone2
CCTTCCCCACGGATAG-1	immune cells_clone2
CGATCGGTCCGCGTTT-1	immune cells_clone2
CGATGGCGTTCAGACT-1	immune cells_clone2
CGATGGCTCATGCTCC-1	immune cells_clone2
CGATGTAGTAATAGCA-1	immune cells_clone2
CGCCAAGCAGGGATTG-1	immune cells_clone2
CGCGGTACAAAGTGCG-1	immune cells_clone2
CGGACTGCAAAGGAAG-1	immune cells_clone2
CGGTTAATCTAGAGTC-1	immune cells_clone2
CGTCCATTCGAATGCT-1	immune cells_clone2
CGTGAGCTCCATGAGT-1	immune cells_clone2
CGTTGGGTCAAAGACA-1	immune cells_clone2
CTAAGACTCCAAATGC-1	immune cells_clone2
CTAATGGGTTCGGGCT-1	immune cells_clone2
CTACCCATCATATCGG-1	immune cells_clone2
CTAGCCTAGACGCAAC-1	immune cells_clone2
CTCACACAGCTAGTCT-1	immune cells_clone2
CTCATTATCAGGCGAA-1	immune cells_clone2
CTCCTAGTCGAGAACG-1	immune cells_clone2
CTCGAGGCACCATCCT-1	immune cells_clone2
CTCTAATTCACAGTAC-1	immune cells_clone2
CTGATCCAGCAGGTCA-1	immune cells_clone2
CTTACCGAGGCTACGA-1	immune cells_clone2
CTTTGCGGTACTCTCC-1	immune cells_clone2
GAAACTCCACATCCGG-1	immune cells_clone2
GAAACTCGTGGTGTAG-1	immune cells_clone2
GAATAAGTCATTATCC-1	immune cells_clone2
GAATGAAGTGCACGAA-1	immune cells_clone2
GACACGCAGACGCAAC-1	immune cells_clone2
GACAGAGAGGAGTTTA-1	immune cells_clone2
GACCAATAGCTGATAA-1	immune cells_clone2
GACGTGCAGAGGGCTT-1	immune cells_clone2
GACGTTAGTAGCCTCG-1	immune cells_clone2
GACTAACGTTGCCTCT-1	immune cells_clone2
GAGGTGAAGCCAGGAT-1	immune cells_clone2
GAGGTGACAGTCAGAG-1	immune cells_clone2
GATCAGTCATGTCCTC-1	immune cells_clone2
GATCGATGTCTAGTCA-1	immune cells_clone2
GATTCAGAGCCAACAG-1	immune cells_clone2
GCACTCTGTTCAGCGC-1	immune cells_clone2
GCAGCCAGTGACTCAT-1	immune cells_clone2
GCATACAAGCGATGAC-1	immune cells_clone2
GCATGATGTAATTGGA-1	immune cells_clone2
GCATGCGTCAGTTGAC-1	immune cells_clone2
GCGCCAAAGATATGCA-1	immune cells_clone2
GCGCCAAAGCTAGTGG-1	immune cells_clone2
GCTCTGTGTCGGCTCA-1	immune cells_clone2
GCTGCTTCAAGAAGAG-1	immune cells_clone2
GCTTGAACACTTAACG-1	immune cells_clone2
GGACAAGGTTCGTCTC-1	immune cells_clone2
GGACAGAGTGGCCCTA-1	immune cells_clone2
GGACATTTCTGCCCTA-1	immune cells_clone2
GGAGCAATCGAACTGT-1	immune cells_clone2
GGCGACTCACGTAAGG-1	immune cells_clone2
GGCGACTGTTGGAGGT-1	immune cells_clone2
GGGACCTCAGCCTTGG-1	immune cells_clone2
GGGACCTTCTGTCCGT-1	immune cells_clone2
GGGAGATAGCATGGCA-1	immune cells_clone2
GGGAGATGTGTTGGGA-1	immune cells_clone2
GGGTTGCCACTTAACG-1	immune cells_clone2
GGTGCGTCATAACCTG-1	immune cells_clone2
GGTGTTATCCAGTAGT-1	immune cells_clone2
GGTGTTATCTGCTGCT-1	immune cells_clone2
GTACTCCTCCAAAGTC-1	immune cells_clone2
GTACTCCTCTCTTATG-1	immune cells_clone2
GTAGTCAAGATCTGAA-1	immune cells_clone2
GTAGTCATCTCATTCA-1	immune cells_clone2
GTCGGGTAGCGAAGGG-1	immune cells_clone2
GTGCATATCGCATGGC-1	immune cells_clone2
GTGGGTCTCACGCGGT-1	immune cells_clone2
TAAACCGGTATAGGTA-1	immune cells_clone2
TACACGATCGCAGGCT-1	immune cells_clone2
TAGACCATCAACCATG-1	immune cells_clone2
TAGGCATTCTACTTAC-1	immune cells_clone2
TCACGAACACGTTGGC-1	immune cells_clone2
TCATTTGGTCAGTGGA-1	immune cells_clone2
TCGCGAGGTTATCGGT-1	immune cells_clone2
TCTGAGACAGCAGTTT-1	immune cells_clone2
TGAAAGAAGGGAAACA-1	immune cells_clone2
TGACAACAGTACGACG-1	immune cells_clone2
TGAGCCGGTATGCTTG-1	immune cells_clone2
TGCCCATTCCGTAGTA-1	immune cells_clone2
TGCCCATTCGGCGCAT-1	immune cells_clone2
TGCGGGTTCGTTTGCC-1	immune cells_clone2
TGCGTGGTCACATGCA-1	immune cells_clone2
TGCTACCAGTGGGCTA-1	immune cells_clone2
TGGACGCAGCCATCGC-1	immune cells_clone2
TGGACGCCATGCCACG-1	immune cells_clone2
TGGGAAGCATGCAACT-1	immune cells_clone2
TGGTTCCAGATGCCAG-1	immune cells_clone2
TGTCCCACAACTGCGC-1	immune cells_clone2
TGTTCCGCACAGCCCA-1	immune cells_clone2
TGTTCCGTCCCAAGTA-1	immune cells_clone2
TTAACTCCAAGGACTG-1	immune cells_clone2
TTATGCTAGGGAACGG-1	immune cells_clone2
TTGCGTCCAAACCTAC-1	immune cells_clone2
TTGGAACGTTACAGAA-1	immune cells_clone2
TTTGGTTAGGTAAACT-1	immune cells_clone2
TTTGGTTTCGGCCGAT-1	immune cells_clone2
TTTGTCAAGATCTGCT-1	immune cells_clone2
AACTCCCTCTCTAGGA-1	stem, cancer cell_clone1
AAGGTTCGTGACTCAT-1	stem, cancer cell_clone1
ACACCAACACTGTTAG-1	stem, cancer cell_clone1
ACATCAGTCTACTATC-1	stem, cancer cell_clone1
ACCAGTAGTAAAGGAG-1	stem, cancer cell_clone1
ACCTTTAGTGCAACGA-1	stem, cancer cell_clone1
ACGAGGACACAAGTAA-1	stem, cancer cell_clone1
ACGATACGTCGACTAT-1	stem, cancer cell_clone1
ACGATGTGTGCCTGGT-1	stem, cancer cell_clone1
ACGGGTCTCACTTACT-1	stem, cancer cell_clone1
ACTTGTTTCCGTTGCT-1	stem, cancer cell_clone1
ACTTTCACAAAGGTGC-1	stem, cancer cell_clone1
AGATCTGCAAAGGTGC-1	stem, cancer cell_clone1
AGCGGTCAGGCCCTTG-1	stem, cancer cell_clone1
AGCTTGATCAACGCTA-1	stem, cancer cell_clone1
AGGTCATTCCCAACGG-1	stem, cancer cell_clone1
AGTCTTTCATACAGCT-1	stem, cancer cell_clone1
AGTGGGACAGGGTTAG-1	stem, cancer cell_clone1
AGTTGGTTCCTTTCGG-1	stem, cancer cell_clone1
ATCACGAGTGAAGGCT-1	stem, cancer cell_clone1
ATCCACCAGGAATCGC-1	stem, cancer cell_clone1
ATCTGCCAGTCTCCTC-1	stem, cancer cell_clone1
ATGTGTGGTCGCTTTC-1	stem, cancer cell_clone1
ATGTGTGTCGCAGGCT-1	stem, cancer cell_clone1
ATTGGACGTCTAGTCA-1	stem, cancer cell_clone1
CAAGGCCCAAGTCTAC-1	stem, cancer cell_clone1
CAAGGCCGTCTAAAGA-1	stem, cancer cell_clone1
CACACAACAATCCGAT-1	stem, cancer cell_clone1
CACACAACAGCCTTTC-1	stem, cancer cell_clone1
CACATAGCAGTTCATG-1	stem, cancer cell_clone1
CACCTTGTCACGACTA-1	stem, cancer cell_clone1
CACTCCAGTCACCTAA-1	stem, cancer cell_clone1
CAGCCGACATTGGGCC-1	stem, cancer cell_clone1
CAGCGACTCTTGTTTG-1	stem, cancer cell_clone1
CATCAGATCACTCTTA-1	stem, cancer cell_clone1
CATCCACCAAGGTTCT-1	stem, cancer cell_clone1
CCACGGAGTAGCACGA-1	stem, cancer cell_clone1
CCATTCGCACGGATAG-1	stem, cancer cell_clone1
CCGGTAGCACTAGTAC-1	stem, cancer cell_clone1
CCTACCAAGCGTCTAT-1	stem, cancer cell_clone1
CCTCTGAGTACCGAGA-1	stem, cancer cell_clone1
CCTTCGAAGAAGGGTA-1	stem, cancer cell_clone1
CGAGCACAGGAGCGAG-1	stem, cancer cell_clone1
CGATGTATCGGCGGTT-1	stem, cancer cell_clone1
CGCCAAGGTGTGAATA-1	stem, cancer cell_clone1
CGCGTTTAGGCAGGTT-1	stem, cancer cell_clone1
CGGAGTCTCGTCTGCT-1	stem, cancer cell_clone1
CGGCTAGGTTATCACG-1	stem, cancer cell_clone1
CGTAGCGAGTCCTCCT-1	stem, cancer cell_clone1
CGTCACTCAAGTACCT-1	stem, cancer cell_clone1
CGTCACTTCGTTGCCT-1	stem, cancer cell_clone1
CGTCAGGCAGCCAATT-1	stem, cancer cell_clone1
CGTTAGATCAATACCG-1	stem, cancer cell_clone1
CTAACTTGTTCCCTTG-1	stem, cancer cell_clone1
CTACATTCATGTAGTC-1	stem, cancer cell_clone1
CTACGTCCAAGCGATG-1	stem, cancer cell_clone1
CTAGCCTCAATTGCTG-1	stem, cancer cell_clone1
CTCAGAACATTAGCCA-1	stem, cancer cell_clone1
CTCGGAGCATCACGAT-1	stem, cancer cell_clone1
CTGATCCTCCTATTCA-1	stem, cancer cell_clone1
CTGCGGAGTAAGTGTA-1	stem, cancer cell_clone1
CTGCTGTGTCCGAACC-1	stem, cancer cell_clone1
CTGTGCTCACATAACC-1	stem, cancer cell_clone1
CTGTTTATCAGCAACT-1	stem, cancer cell_clone1
CTTGGCTAGATATACG-1	stem, cancer cell_clone1
GAACCTACATCCGGGT-1	stem, cancer cell_clone1
GAAGCAGCAATCAGAA-1	stem, cancer cell_clone1
GAATGAATCAGAGACG-1	stem, cancer cell_clone1
GACCTGGCATGATCCA-1	stem, cancer cell_clone1
GATCGATTCTCTAGGA-1	stem, cancer cell_clone1
GATCGCGGTAGCCTCG-1	stem, cancer cell_clone1
GATGAAATCTCTAAGG-1	stem, cancer cell_clone1
GCAGTTAGTAGCCTCG-1	stem, cancer cell_clone1
GCGACCAAGTGGCACA-1	stem, cancer cell_clone1
GCTGCAGAGTCATGCT-1	stem, cancer cell_clone1
GCTGCTTGTCAAACTC-1	stem, cancer cell_clone1
GGAAAGCAGCTGGAAC-1	stem, cancer cell_clone1
GGAACTTAGCTCCTTC-1	stem, cancer cell_clone1
GGAATAACAAGCTGAG-1	stem, cancer cell_clone1
GGACAAGTCGTTACGA-1	stem, cancer cell_clone1
GGACAGATCCAGATCA-1	stem, cancer cell_clone1
GGACATTCACTAGTAC-1	stem, cancer cell_clone1
GGACATTTCGCTGATA-1	stem, cancer cell_clone1
GGATTACTCTTCAACT-1	stem, cancer cell_clone1
GGCGTGTCAGTTCATG-1	stem, cancer cell_clone1
GGGATGAAGACGCACA-1	stem, cancer cell_clone1
GGGATGATCGCGTTTC-1	stem, cancer cell_clone1
GGGTCTGCAGTAACGG-1	stem, cancer cell_clone1
GGTGTTAAGACGCACA-1	stem, cancer cell_clone1
GGTGTTATCCTCAATT-1	stem, cancer cell_clone1
GTAACGTCAGCTGGCT-1	stem, cancer cell_clone1
GTATCTTGTCTTGCGG-1	stem, cancer cell_clone1
GTCACAACATTAGGCT-1	stem, cancer cell_clone1
GTGCATAAGGCTAGAC-1	stem, cancer cell_clone1
GTGCGGTGTCGACTGC-1	stem, cancer cell_clone1
GTTACAGAGCCACCTG-1	stem, cancer cell_clone1
GTTCATTCACAACTGT-1	stem, cancer cell_clone1
GTTTCTACAAAGCAAT-1	stem, cancer cell_clone1
TAAACCGTCGGCCGAT-1	stem, cancer cell_clone1
TACAGTGAGTGGACGT-1	stem, cancer cell_clone1
TACAGTGGTGAGGGAG-1	stem, cancer cell_clone1
TACGGATAGGATTCGG-1	stem, cancer cell_clone1
TACGGATGTCCTCCAT-1	stem, cancer cell_clone1
TACGGTACAAGGGTCA-1	stem, cancer cell_clone1
TACTTGTTCAAGGCTT-1	stem, cancer cell_clone1
TAGACCATCACGGTTA-1	stem, cancer cell_clone1
TAGAGCTTCCGTAGTA-1	stem, cancer cell_clone1
TAGTGGTCAATAAGCA-1	stem, cancer cell_clone1
TAGTGGTGTATAATGG-1	stem, cancer cell_clone1
TATCAGGAGACGCAAC-1	stem, cancer cell_clone1
TATCAGGCATTGAGCT-1	stem, cancer cell_clone1
TCAGCAAGTATGAATG-1	stem, cancer cell_clone1
TCAGCAATCGATGAGG-1	stem, cancer cell_clone1
TCAGGATTCACTGGGC-1	stem, cancer cell_clone1
TCCCGATCATGTTGAC-1	stem, cancer cell_clone1
TCGAGGCGTCGAGTTT-1	stem, cancer cell_clone1
TCGGGACTCCGCAAGC-1	stem, cancer cell_clone1
TCGGTAACAGTCGTGC-1	stem, cancer cell_clone1
TCGTACCCACATTTCT-1	stem, cancer cell_clone1
TCTGAGAGTACAGACG-1	stem, cancer cell_clone1
TCTTCGGAGGGAGTAA-1	stem, cancer cell_clone1
TCTTCGGCATGAACCT-1	stem, cancer cell_clone1
TGACAACTCACATAGC-1	stem, cancer cell_clone1
TGACGGCGTTACGGAG-1	stem, cancer cell_clone1
TGAGAGGCAAGACGTG-1	stem, cancer cell_clone1
TGAGCATCACGCCAGT-1	stem, cancer cell_clone1
TGCCAAACACGTTGGC-1	stem, cancer cell_clone1
TGCCCATTCCGAAGAG-1	stem, cancer cell_clone1
TGCGCAGGTCAGTGGA-1	stem, cancer cell_clone1
TGCGTGGTCAGCTCGG-1	stem, cancer cell_clone1
TGCTACCAGCACAGGT-1	stem, cancer cell_clone1
TGGCCAGTCAGTTGAC-1	stem, cancer cell_clone1
TGGCGCAGTAGCGATG-1	stem, cancer cell_clone1
TGGTTCCAGTTAGGTA-1	stem, cancer cell_clone1
TGTTCCGCATCCGGGT-1	stem, cancer cell_clone1
TTAACTCCAGTAAGCG-1	stem, cancer cell_clone1
TTAGGACAGCTAGGCA-1	stem, cancer cell_clone1
TTAGGACCACAACGCC-1	stem, cancer cell_clone1
TTAGGACCATGAACCT-1	stem, cancer cell_clone1
TTAGTTCGTGGTACAG-1	stem, cancer cell_clone1
TTCTACACAAATTGCC-1	stem, cancer cell_clone1
TTCTCCTTCTAGAGTC-1	stem, cancer cell_clone1
TTCTTAGAGGCTCATT-1	stem, cancer cell_clone1
TTCTTAGCACGGCGTT-1	stem, cancer cell_clone1
TTGAACGAGATGCCTT-1	stem, cancer cell_clone1
TTGCCGTGTCGGGTCT-1	stem, cancer cell_clone1
TTGCCGTGTTATTCTC-1	stem, cancer cell_clone1
TTGGAACAGCTTATCG-1	stem, cancer cell_clone1
TTTGGTTCATGCCTTC-1	stem, cancer cell_clone1
TTTGTCAAGCAGCGTA-1	stem, cancer cell_clone1
AAACCTGTCACGCATA-1	stem, cancer cell_clone2
AAAGATGAGTGGTCCC-1	stem, cancer cell_clone2
AACACGTCACGGCCAT-1	stem, cancer cell_clone2
AACCATGGTCATTAGC-1	stem, cancer cell_clone2
AACCGCGCACTGCCAG-1	stem, cancer cell_clone2
AACTCAGGTTCAGCGC-1	stem, cancer cell_clone2
AAGCCGCGTTCTGTTT-1	stem, cancer cell_clone2
AATCCAGTCTCCAACC-1	stem, cancer cell_clone2
ACAGCCGGTCTCCCTA-1	stem, cancer cell_clone2
ACAGCCGTCAACACAC-1	stem, cancer cell_clone2
ACAGCTACAGATCTGT-1	stem, cancer cell_clone2
ACCAGTAGTGTGTGCC-1	stem, cancer cell_clone2
ACCCACTCAGTTTACG-1	stem, cancer cell_clone2
ACGATACTCTCTTATG-1	stem, cancer cell_clone2
ACGATGTCAAGACGTG-1	stem, cancer cell_clone2
ACGATGTGTCTTCGTC-1	stem, cancer cell_clone2
ACGATGTTCACCTCGT-1	stem, cancer cell_clone2
ACTGAACTCAAAGACA-1	stem, cancer cell_clone2
ACTGAGTGTTCTCATT-1	stem, cancer cell_clone2
ACTGCTCAGGATGGAA-1	stem, cancer cell_clone2
ACTGCTCCATGGTCTA-1	stem, cancer cell_clone2
ACTTTCATCGATCCCT-1	stem, cancer cell_clone2
AGAGCGAGTGTTGGGA-1	stem, cancer cell_clone2
AGAGCTTAGAAGGGTA-1	stem, cancer cell_clone2
AGAGCTTCAAACAACA-1	stem, cancer cell_clone2
AGAGTGGCAGTATCTG-1	stem, cancer cell_clone2
AGATCTGCAGACGCCT-1	stem, cancer cell_clone2
AGCGTCGGTCTTGATG-1	stem, cancer cell_clone2
AGCTCCTTCCAATGGT-1	stem, cancer cell_clone2
AGCTCTCTCGTTGCCT-1	stem, cancer cell_clone2
AGGGTGATCCCGGATG-1	stem, cancer cell_clone2
ATAAGAGGTCAAAGCG-1	stem, cancer cell_clone2
ATCACGACAATACGCT-1	stem, cancer cell_clone2
ATCACGACAGACAAGC-1	stem, cancer cell_clone2
ATCATCTTCCGCGTTT-1	stem, cancer cell_clone2
ATCATGGTCCTTTACA-1	stem, cancer cell_clone2
ATGGGAGAGATATACG-1	stem, cancer cell_clone2
ATGGGAGTCTGAGTGT-1	stem, cancer cell_clone2
ATTGGTGGTCTCTCGT-1	stem, cancer cell_clone2
CAACCAACACAGCGTC-1	stem, cancer cell_clone2
CAACCTCTCTGCCCTA-1	stem, cancer cell_clone2
CAAGGCCCAAGAGGCT-1	stem, cancer cell_clone2
CACACTCGTATAGGTA-1	stem, cancer cell_clone2
CACATAGGTGGCTCCA-1	stem, cancer cell_clone2
CACATTTCAATCCAAC-1	stem, cancer cell_clone2
CACCAGGGTATCAGTC-1	stem, cancer cell_clone2
CACCTTGAGTCCATAC-1	stem, cancer cell_clone2
CAGCGACCAGTTCATG-1	stem, cancer cell_clone2
CAGCTAAGTGTTTGGT-1	stem, cancer cell_clone2
CATATTCCAGCTGTTA-1	stem, cancer cell_clone2
CATATTCTCCCATTAT-1	stem, cancer cell_clone2
CATGCCTTCTCAAGTG-1	stem, cancer cell_clone2
CCAATCCAGATTACCC-1	stem, cancer cell_clone2
CCACCTATCCTGCCAT-1	stem, cancer cell_clone2
CCATTCGCACGTGAGA-1	stem, cancer cell_clone2
CCCTCCTCAAGAGTCG-1	stem, cancer cell_clone2
CCGGTAGCATTACCTT-1	stem, cancer cell_clone2
CCTAGCTCAACGCACC-1	stem, cancer cell_clone2
CCTCAGTCAGCTCGCA-1	stem, cancer cell_clone2
CCTTCCCAGCTACCGC-1	stem, cancer cell_clone2
CCTTCCCCAAGCCCAC-1	stem, cancer cell_clone2
CCTTTCTTCTGGCGTG-1	stem, cancer cell_clone2
CGACCTTGTGCGGTAA-1	stem, cancer cell_clone2
CGACTTCAGTGGCACA-1	stem, cancer cell_clone2
CGACTTCGTCAAGCGA-1	stem, cancer cell_clone2
CGACTTCTCAACACTG-1	stem, cancer cell_clone2
CGAGAAGAGAGTTGGC-1	stem, cancer cell_clone2
CGATGTAAGCAGCCTC-1	stem, cancer cell_clone2
CGGACACGTAGCTCCG-1	stem, cancer cell_clone2
CGGACTGTCCTCAACC-1	stem, cancer cell_clone2
CGGAGTCCACGTCTCT-1	stem, cancer cell_clone2
CGTAGGCGTAAGGGCT-1	stem, cancer cell_clone2
CGTCTACAGTACGCGA-1	stem, cancer cell_clone2
CTAACTTGTGATGCCC-1	stem, cancer cell_clone2
CTACATTAGCCCAATT-1	stem, cancer cell_clone2
CTAGTGAGTAGCGCAA-1	stem, cancer cell_clone2
CTAGTGAGTCAGCTAT-1	stem, cancer cell_clone2
CTAGTGAGTTGCTCCT-1	stem, cancer cell_clone2
CTCATTAAGGGAAACA-1	stem, cancer cell_clone2
CTCGAGGCAGGATCGA-1	stem, cancer cell_clone2
CTCGAGGGTCTAGAGG-1	stem, cancer cell_clone2
CTCGGGAGTTGTACAC-1	stem, cancer cell_clone2
CTCTGGTAGCGCTCCA-1	stem, cancer cell_clone2
CTGCGGATCTTGAGAC-1	stem, cancer cell_clone2
CTGGTCTCACGCATCG-1	stem, cancer cell_clone2
CTGTGCTTCCCTTGCA-1	stem, cancer cell_clone2
CTGTTTATCATCGATG-1	stem, cancer cell_clone2
GAAACTCTCCTCTAGC-1	stem, cancer cell_clone2
GAAATGAGTAAAGTCA-1	stem, cancer cell_clone2
GAAATGAGTAATTGGA-1	stem, cancer cell_clone2
GAACCTACAACGATCT-1	stem, cancer cell_clone2
GAAGCAGCAAAGGCGT-1	stem, cancer cell_clone2
GAAGCAGTCAACGGGA-1	stem, cancer cell_clone2
GACACGCTCACCACCT-1	stem, cancer cell_clone2
GACTACAAGTTTGCGT-1	stem, cancer cell_clone2
GATCGATGTATATGGA-1	stem, cancer cell_clone2
GATCGTACACGGTAAG-1	stem, cancer cell_clone2
GATGAGGAGATCCTGT-1	stem, cancer cell_clone2
GCAAACTCAGCTCGAC-1	stem, cancer cell_clone2
GCAAACTTCACCACCT-1	stem, cancer cell_clone2
GCAATCATCTAAGCCA-1	stem, cancer cell_clone2
GCACATAGTAGCTAAA-1	stem, cancer cell_clone2
GCACTCTGTATAGGGC-1	stem, cancer cell_clone2
GCATGATCAATGAATG-1	stem, cancer cell_clone2
GCCAAATCAATCGAAA-1	stem, cancer cell_clone2
GCGCAGTAGTCCCACG-1	stem, cancer cell_clone2
GCGCGATCAAGAGGCT-1	stem, cancer cell_clone2
GCGCGATGTACCGTAT-1	stem, cancer cell_clone2
GCTTCCAGTAGAAAGG-1	stem, cancer cell_clone2
GGACAAGTCTCTGAGA-1	stem, cancer cell_clone2
GGATGTTTCACCGGGT-1	stem, cancer cell_clone2
GGCAATTAGGCAGGTT-1	stem, cancer cell_clone2
GGCAATTAGTGTACGG-1	stem, cancer cell_clone2
GGCCGATTCATGCTCC-1	stem, cancer cell_clone2
GGCTCGAAGGTGGGTT-1	stem, cancer cell_clone2
GGCTCGACACACTGCG-1	stem, cancer cell_clone2
GGGATGAGTTGAGTTC-1	stem, cancer cell_clone2
GGGCACTCAGCTCGAC-1	stem, cancer cell_clone2
GTGCTTCCACAGCCCA-1	stem, cancer cell_clone2
GTGCTTCGTCGGCACT-1	stem, cancer cell_clone2
GTTCTCGCAATGGTCT-1	stem, cancer cell_clone2
TAAACCGGTAGAAAGG-1	stem, cancer cell_clone2
TACCTTATCCTCATTA-1	stem, cancer cell_clone2
TACGGTACAGTCGATT-1	stem, cancer cell_clone2
TACTCATGTCAATGTC-1	stem, cancer cell_clone2
TACTTACCATGGAATA-1	stem, cancer cell_clone2
TACTTGTCAGACAGGT-1	stem, cancer cell_clone2
TAGAGCTCAGTTCCCT-1	stem, cancer cell_clone2
TATTACCTCCGCGTTT-1	stem, cancer cell_clone2
TCAACGATCGCGATCG-1	stem, cancer cell_clone2
TCACAAGTCCAGTAGT-1	stem, cancer cell_clone2
TCAGGATGTAGCCTCG-1	stem, cancer cell_clone2
TCGAGGCTCACAGTAC-1	stem, cancer cell_clone2
TCGCGTTAGACGCTTT-1	stem, cancer cell_clone2
TCGCGTTCAGACAAGC-1	stem, cancer cell_clone2
TGAAAGACACAGAGGT-1	stem, cancer cell_clone2
TGAAAGACAGGAATGC-1	stem, cancer cell_clone2
TGAGGGAAGTTGTCGT-1	stem, cancer cell_clone2
TGCGTGGCATTACCTT-1	stem, cancer cell_clone2
TGCTGCTCACTAAGTC-1	stem, cancer cell_clone2
TGGACGCCACAGACAG-1	stem, cancer cell_clone2
TGGCGCAGTCGCATAT-1	stem, cancer cell_clone2
TGGGCGTTCTGTCCGT-1	stem, cancer cell_clone2
TGGTTAGGTCGATTGT-1	stem, cancer cell_clone2
TGTATTCGTACCATCA-1	stem, cancer cell_clone2
TGTCCCATCGTACGGC-1	stem, cancer cell_clone2
TTGGCAAGTCGCGAAA-1	stem, cancer cell_clone2
TTGGCAATCCTACAGA-1	stem, cancer cell_clone2
TTTGGTTCAGCTGTAT-1	stem, cancer cell_clone2
TTTGTCAGTGGGTATG-1	stem, cancer cell_clone2
